11111111111111111111
10000000000000000001
1111110000C000011101
1P000000111110000E01
11111111111111111111