11111111111111111111111111111111
11111111111111111111111111111111
1000000C111111000000000000000001
10000000111110000000000000000001
1P000000E10000000000000000000001
10000000111110000000000000000001
1000000C111111000000000000000001
11111111111111111111111111111111
11111111111111111111111111111111