111111111111111
111000000000P11
100001000111111
111001000C00001
100000011110E01
111111111111111