11111111111111111111111
11111111111111111111111
111110001000001C0000001
111100011000X0111110011
1P000000000000000000001
111111111111111E1111111
11111000000000000000001
11111000000000000000001
11111111111111111111111