1111111111111111111111111111111111
1E0000000000000C00000C000000000001
1010010100100000101001000000010101
1010010010101010001001000000010101
1P0000000C00C0000000000000000000C1
1000000C11111111110000001000000001
11111000000000C1110000001000000111
1111100000001111110000000000011111
1111111000000000010000000000000001
111000000C000000000000000000000001
1111111111111111111111111111111111