1111111111111111111111111111111111111111111111111111111111111111111111111111111111111111111111111111
1E0000000000000C00000C00000000000110000000000000C00000C00000000000110000000000000C00000C000000000001
1010010100100000101001000000010100000010100100000101001000000101000010010100100000101001000000101011
1010010010101010001001000000010101101001010101010001001000000010101101001010101010001001000000010101
1P0000000C00C0000000000000000000C1100000000C00C0000000000000000000C1100000000C00C0000000000000000001
1111111111111111111111111111111111111111111111111111111111111111111111111111111111111111111111111111
