1111111111111111111111111111
1111100000000000P00000111111
11111000X0000000000000111111
1111111111111100000111111111
1111110C00000000X00001111111
1111111111100000000000111111
1111111000000000000011111111
11111111111111111E1111111111
1111111111111111111111111111