111111111111111111111111111111111111111111111
10000000E111111111111111111111111111111111111
10000X00C111111111111111111111111111111111111
10000000P111111111111111111111111111111111111
111111111111111111111111111111111111111111111
111111111111111111111111111111111111111111111